k -> north
j -> south
h -> west
l -> east
y -> northwest
u -> northeast
b -> southwest
n -> southeast
K -> run_north
J -> run_south
H -> run_west
L -> run_east
Y -> run_northwest
U -> run_northeast
B -> run_southwest
N -> run_southeast
g -> run_direction
t -> throw
e -> use
a -> launch
s -> aim
d -> quick_shot
, -> pickup
> -> map_interaction


Q -> quit
i -> inventory
c -> character
o -> log
m -> monsters
I -> items
? -> help

U -> overlay_monsters
O -> overlay_items

F2 -> gamma_down
F3 -> gamma_up
Ctrl+T -> themes
F10 -> wizard
